111111111111
100000000001
100000000000
100002000000
100000000000
100000000001
111111111111