111111111111
100000000001
000000000000
000000000000
000000000000
100000000001
111111111111