111111111111
170000000001
100040000000
100000004000
100004000000
100000000001
111111111111