111111111111
100000000001
100050000001
100000000001
100000000001
100000000001
1111CCCC1111