1111aaaa1111
100000000001
100000000000
100032000000
100000000000
100000000001
1111BBBB1111