111111111111
100000000001
00000000000Z
00000000000Z
00000000000Z
100000000001
111111111111