111111111111
100000000001
100006000001
Z0000000000Z
100000000001
100000000001
111111111111