111111111111
100000000001
Z00000000001
Z00000090001
Z00000000001
100000000001
111111111111