1111CCCC1111
100000000001
100000000000
100000000000
100000000000
100000000001
111111111111