1111BBBB1111
100000000001
00000000000c
00000000000c
00000000000c
100000000001
111111111111