111111111111
100000000001
c00000400001
c00000004001
c00040000001
100000000071
111111111111