111111111111
100000000001
100005000001
100000000001
100000000001
100000000001
1111AAAA1111