1111AAAA1111
170000000001
100000000001
100000000001
100000000001
100000000001
111100001111