11111Z111111
100000000001
000000000000
000000000000
000000000000
100000000001
1111BBBB1111