111111111111
100000000001
000000500001
000000000001
000000000001
100000000001
111111111111