1111BBBB1111
100000000001
100000000001
100000000001
100000000001
100000000001
11111Z111111