111100001111
100000000001
100000000001
10006000000Z
100000000001
100000000001
111111111111