111111111111
100000000001
00000000000A
00000400000A
00000000000A
100000000001
1111aaaa1111