111111111111
100000000001
A00000000001
A00000900001
A00000000001
100000000001
111111111111