1111aaaa1111
100000000001
100000000001
10000G000001
100000000001
100000000071
111111111111